##################################################
#GGG#............................................#
#G###......#....#.#....###..###....##...#......#.#
#.#........#....#.#....###..###....##...#......#.#
#..........#....#.#....###..###....##...#......#.#
#.#.###....#....###....#....###....#....###....#.#
#...#.#.#....#...........#.#..###...#....#.#.#...#
#...#.#.#...##.#..###....#.#..###...##...#.#.#...#
#...#.#.#..###.#..###....#.#..###...###..#.#.#...#
#...#..#..####.#..###....#.#..###...####.....#...#
#...#....#####......##...#.#........#####....#...#
#.#.###....#....###....#....###..#.#....###....#.#
#.#.###..#.#....###....#.#..###..#.#....###.##.#.#
#.#.###.#..#....###.#..#.#..###..#.#....###.##.#.#
#.#.###.#..#.#..###.#..#....###..#.#....###....#.#
#.#.###....#....###....#....###....#....###..#.#.#
#...#...#...##...###...####...###...##.......#...#
#...#.#.#.#.##.#.###.#.####.#.###.#.##..###..#...#
#...#...#...##...###...####...###...##.......#...#
#.#.###....#....###....#....###....#....###....#.#
#...#........#....###....#.....#....#........#...#
#...#.#..#..##.#..###.#..#.#..###...##.......#...#
#...#.#..#.###.#..###.#..#.#..###...###......#...#
#...#.#...####.#..###....#.#..###...####.....#...#
#...#....#####...........#..........#####....#...#
#.#.###....#....###....#....###....#....###....#.#
#.#.###.##.#....###....#....###....#....###....#.#
#.#.###.##.#....###....#....###....#....###....#.#
#.#.###....#....###....#....###....#....###....#.#
#.#.###....#....###....#....###....#....###....#.#
#...#.......##...###...####...###...##.......#...#
#...#.......##...###...####...###...##.......#...#
#...#.......##...###...####...###...##.......#...#
#.#.###....#....###....#....###....#....###....#.#
#...#........#...........#..........#...##...#...#
#...#.......##....###....#....###...##..##...#...#
#...#......###....###....#....###...###...##.#...#
#...#.....####....###....#....###...####..##.#...#
#...#....#####...........#..........#####....#...#
#.#.###....#....###....#....###....#....###....#.#
#...#.......##...###...####...###...##.......#...#
#...#.......##...###...####...###...##.......#...#
#...#.......##...###...####...###...##.......#...#
#.#.###....#....###....#....###....#....###....#.#
#.#.###....#....###....#....###....#....###....#.#
#.#.###....#....###....#....###....#....###....#.#
#.#.###....#....###....#....###....#....###....#.#
#.#.###....#....###....#....###....#....###....#.#
#................................................#
##################################################