##################################################
#...#............................................#
#.###......#....#.#....###..###....##...#......#.#
#.#........#....#.#....###..###....##...#......#.#
#..........#....#.#....###..###....##...#......#.#
#.#.###....#....###....#....###....#....###....#.#
#...#.#.#.......................#...#........#...#
#...#.#.#...##.#..###....#.#..###...##...#.#.#...#
#...#.#.#..###.#..###....#.#..###...###..#.#.#...#
#...#..#..####.#..###....#.#..###...####.....#...#
#........#####.......#...#.#........###......#...#
#.#.###.........###....#....###..#.#....###....#.#
#.#.###..#.#....###....#.#..###..#.#....###.##.#.#
#.#.###.#..#....###.#..#.#..###..#.#....###.##.#.#
#.#.###.#..#.#..###.#..#....###..#.#....###....#.#
#.#.###....#....###....#....###....#....###..#.#.#
#...#...#...##...###...####...###...##.......#...#
#...#.#.#.#.##.#.###.#.####.#.###.#.##..###..#...#
#...#...#...##...###...####...###...##.......#...#
#.#.###....#....###....#....###....#....###......#
#...#........#......#........................#...#
#...#.#..#..##.#..###.#..#.#..###...##.......#...#
#...#.#..#.###.#..###.#..#.#..###...###......#...#
#...#.#...####.#..###....#.#..###...####.....#...#
#...#....#####...........#..........#####....#...#
#.#.#...........###....#....###...........#....#.#
#.#.###.##.#....###....#....###....#....###....#.#
#.#.....##.#....###....#....###....#....###....#.#
#.#.###....#....###....#....###....#...........#.#
#.#.###....#....###....#....###....#....###....#.#
#...........##...###...####...###...##.......#...#
#...#.......##.........####...###...##.......#...#
#...#.......##...###...####...###...##.......#...#
#.#.###....#....###....#....###.........###....#.#
#...#........#...........#..........#...##...#...#
#...#.......##....###....#....###...##..##...#...#
#..........###....###....#....###...###...##.#...#
#...#.............###....#....###...####.....#...#
#...#....#####...........#..........#####....#...#
#...###.........###....#....###....#....###....#.#
#...#.......##...###...####...###...##.......#...#
#...........##.........####.........##.......#...#
#...#.......##...###...####...###...##.......#...#
#.#.###....#...........#....###....#....###....#.#
#.#.###....#....###....#....###....#....###....#.#
#.#.###....#....###....#.......................#.#
#.#.###....#....###....#....###....#....###....#.#
#.#.###....#....###....#....###....#....###....#.#
#................................................#
##################################################