##################################################
#...#............................................#
#.###.....#....###....###..###....##....#......#.#
#.#.......#....###....###..###....##....#......#.#
#.........#....###....###..###....##....#......#.#
#..#####..#....###....###..###....##....#..#####.#
#................................................#
#.#######...##....###..#.#.#..###...##...#######.#
#.###......###....###..#.#.#..###...###......###.#
#.###.....####....###..#.#.#..###...####.....###.#
#................................................#
#.#.###....#.#..###....#..#....###..#.#....###.#.#
#.#.###....#.#..###....#..#....###..#.#....###.#.#
#.#.###....#.#..#####..#..#..#####..#.#....###.#.#
#.#.###....#.#..#####..#..#..#####..#.#....###.#.#
#.#.###....#....####...#..#...####....#....###.#.#
#................................................#
#...#.......##...###...####...###...##.......#...#
#...#.......##...###...####...###...##.......#...#
#..#####....#.....##############....#....######..#
#...#........................................#...#
#...#.......##....###.######..###...##.......#...#
#...#......###....###.######..###...###......#...#
#...#.....####....###.######..###...####.....#...#
#...#.....####......................####.....#...#
#.#####..........###....#....###...........#####.#
#.#####....#.....###....#....###......#....#####.#
#..........#.....###....#....###......#..........#
#...###....#.....###....#....###......#....###...#
#...###....#.....###....#....###......#....###...#
#...#.......##...###...####...###...##.......#...#
#...#.......##...###...####...###...##.......#...#
#...#.......##...###...####...###...##.......#...#
#................................................#
#...#...##...#....#......#......#...#...##...#...#
#...#...##..##....###....#....###...##..##...#...#
#...#.##...###....###....#....###...###...##.#...#
#...#.....####....###....#....###...####.....#...#
#.###....#####...........#..........#####....###.#
#.#.............###............###.............#.#
#.###...##...##...##...####...##...##...##...###.#
#.###........##...##...####...##...##........###.#
#.###........##...##...####...##...##........###.#
#.#.###.....#....###....##....###....#.....###.#.#
#.#.###.....#....###....##....###....#.....###.#.#
#.#.###.....#....###....##....###....#.....###.#.#
#.#.###.....#....###....##....###....#.....###.#.#
#.#.###.....#....###...####...###....#.....###.#.#
#.#.....###..........#......#..........###.......#
##################################################