##################################################
#GGG#............................................#
#G###......#....#.#....###..###....##...#......#.#
#.#........#....#.#....###..###....##...#......#.#
#..........#....#.#....###..###....##...#......#.#
#.#.###....#....###....#....###....#....###....#.#
#...#.#.#.......................#...#........#...#
#...#.#.#...##.#..###....#.#..###...##...#.#.#...#
#...#.#.#..###.#..###....#.#..###...###..#.#.#...#
#...#..#..####.#..###....#.#..###...####.....#...#
#........#####.......#...#.#........###......#...#
#.#.###.........###....#....###..#.#....###....#.#
#.#.###..#.#....###....#.#..###..#.#....###.##.#.#
#.#.###.#..#....###.#..#.#..###..#.#....###.##.#.#
#.#.###.#..#.#..###.#..#....###..#.#....###....#.#
#.#.###....#....###....#....###....#....###..#.#.#
#...#...#...##...###...####...###...##.......#...#
#...#.#.#.#.##.#.###.#.####.#.###.#.##..###..#...#
#...#...#...##...###...####...###...##.......#...#
#.#.###....#....###....#....###....#....###....#.#
#...#........#......#........................#...#
#...#.#..#..##.#..###.#..#.#..###...##.......#...#
#...#.#..#.###.#..###.#..#.#..###...###......#...#
#...#.#...####.#..###....#.#..###...####.....#...#
#...#....#####...........#..........#####....#...#
#.#.###....#....###....#....###....#....###....#.#
#.#.###.##.#....###....#....###....#....###....#.#
#.#.###.##.#....###....#....###....#....###....#.#
#.#.###....#....###....#....###....#....###....#.#
#.#.###....#....###....#....###....#....###....#.#
#...#.......##...###...####...###...##.......#...#
#...#.......##...###...####...###...##.......#...#
#...#.......##...###...####...###...##.......#...#
#.#.###....#....###....#....###....#....###....#.#
#...#........#...........#..........#...##...#...#
#...#.......##....###....#....###...##..##...#...#
#...#......###....###....#....###...###...##.#...#
#...#.....####....###....#....###...####..##.#...#
#...#....#####...........#..........#####....#...#
#.#.###....#....###....#....###....#....###....#.#
#...#.......##...###...####...###...##.......#...#
#...#.......##...###...####...###...##.......#...#
#...#.......##...###...####...###...##.......#...#
#.#.###....#....###....#....###....#....###....#.#
#.#.###....#....###....#....###....#....###....#.#
#.#.###....#....###....#....###....#....###....#.#
#.#.###....#....###....#....###....#....###....#.#
#.#.###....#....###....#....###....#....###....#.#
#................................................#
##################################################